..............
.S----1.3---E.
......|.|.....
.3----2.|.....
.|......|.....
.4------2.....
..............